
NO test_north_textures.xpm 
EA test_east_textures.xpm
SO test_south_textures.xp
F 160,82,45
C 135,206,235

WE test_west_textures.xpm


111111111111111111111111111111111111111111111
1E00000000000000000100000000000100000000000001
1100000000100000000100000000000100000000000001
1111100000000000000100000000000100000000000001
1111100000000000000100000000000100000000000001
1111100000000000000100000000000100000000000001
1111100000000000000100000000000100000000000001
1111100000000000000100000000000100000000000001
1111100000000000000000000000000100000000000001
1111100000000000000100000000000000000000000001
1111100000000000000100000000000100000000000001
1111100000000000000100000000000100000000000001
1111100000000000000100000000000100000000000001
1111100000000000000100000000000100000000000001
1111100000000000000100000000000100000000000001
1111100000000000000100000000000100000000000001
1111100000000000000100000000000100000000000001
1111100000000000000100000000000100000000000001
1111100000000000000000000000000100000000000001
1111100000000000001111111111111111111011111111
1111111111101111101111111111111111111011111111
          1001  101                 101
          1001  101                 101
          1001  101                 101
          1001  101                 101
          1001  10111111111111111111101
          101   100000000000000000000001
          101   11111111111001111111101
          101             1001      101
1111111111101111111       1001      101
1100000000100000001       1001      101
1111100000000000001       1001      101
1111100000000000001       1001      101
111110000000000000111111111001111111101
111110000000000000000000000000000000001
111110000000000000111111111111111111111
1111100000000000001
1111111111111111111