
NO test_north_textures.xpm 
EA test_east_textures.xpm
SO test_south_textures.xp
F 35,19,73
C 15,6,30

WE test_west_textures.xpm


1111111111111111111
1E00000000000000001
1100000000100000001
1111100000000000001
1111111111111111111