
NO test_north_textures.xpm 
EA test_east_textures.xpm
SO test_south_textures.xp
F 35,19,73
C 15,6,30

WE test_west_textures.xpm


   111111                 1
  10000001               101
 10000011                1011
 100000011111            10101
 110000010001111111111111101001
 111000000N000000000000000010001
 1111001111110011111111111010001
 111100111111001         100000111111111111111
 11100000000001          100000000000000000001
 1111111111111            10000000001000000001
                          1000000000100000001
                          1000000001000000001
                          1000000000000000001
                          1111111111111111111