
NO test_north_textures.xpm 
EA test_east_textures.xpm
SO test_south_textures.xp
F 35,19,73
C 15,6,30

WE test_west_textures.xpm


111111111111111111111111111111111111111
100000000000000000000100000000000000001
1100000000E0000000000010000000000000001
111110000000000000000000001000000000001
111111111111111111111111111111111111111